R 640 480

NO textures/eagle.xpm
SO textures/redbrick.xpm
WE textures/purplestone.xpm
EA textures/greystone.xpm
S textures/barrel.xpm

F 0,0,0
C 225,255,0

11111111111111111111
10000000000000000001
10E00000200000200001
10000000000000000001
11111111111111111111