R 1000 480

NO textures/eagle.xpm
SO textures/redbrick.xpm
WE textures/purplestone.xpm
EA textures/greystone.xpm
S textures/barrel.xpm

F 220,100,0
C 100,200,0

        1111111111111111111111111
        1000000000110000000000001
        1011000001110000002000001
        1001000000000000000000001
111111111011000001110000000000001
1000000000110000011101111111111111111
11110111111111011100000010001
11110111111111011101010010001
11110111111111011101010010001
111101111111110111010100100011111111111111111
11110111111111011101010010001
11110111111111011101010010001
11110111111111011101010010001111111111
11110111111111011101010010001
1111011111111101110101001000111
1111011111111101110101001000001
1111011111111101110101001000111
11110111111111011101010010001
1111011111111101110101001000111111
111101111111110111010100100000111111
1111011111111101110101001000111111
11000000110101011100000010001
10002000000000001100000000001
10000000000000001101010010001
11000001110101011111011110N0111
11110111 1110101 101111010001
11111111 1111111 111111111111