R 640 480

NO textures/eagle.xpm
SO textures/redbrick.xpm
WE textures/purplestone.xpm
EA textures/greystone.xpm
S ./path_to_the_sprite_texture

F 225,225,0
C 225,30,0

11111111111
10000000001
10000000w21
11111111111