R 360 240

NO textures/eagle.xpm
SO textures/redbrick.xpm
WE textures/purplestone.xpm
EA textures/greystone.xpm
S textures/barrel.xpm

F 225,225,0
C 225,30,0

11111111111111111111
10000000000000000001
100S0000200000200001
10000000000000000001
11111111111111111111