R 640 480

NO textures/eagle.xpm
SO textures/redbrick.xpm
WE textures/purplestone.xpm
EA textures/greystone.xpm
S textures/barrel.xpm

F 225,225,0
C 225,30,0

111111111111111111111111
100000000000000000000001
100000002000000000000001
100000000000000000000001
1000000020000000S0000001
100000000000000000000001
100000002000000000000001
100000000000000000000001
111111111111111111111111